USER/KORISNIK:

    company -> Naziv tvrtke
    address -> Adresa
    city -> Grad
    firstName -> Ime
    lastName -> Prezime
    telephone -> Telefon
    emailTosend -> e-mail za slanje (e-mail računovodstvenog servisa)
    username -> Korisničko ime
    password -> Lozinka
    showAllApplications -> Prikaz svih naloga

EMPLOYEE/RADNIK:

    firstName -> Ime
    lastName -> Prezime
    gender -> Spol
    dateOfBirth -> Datum rođenja
    address -> Adresa
    city -> Grad
    professionalQualification -> Stvarna stručna sprema
    highestLevelOfEducation -> Naziv najviše završene škole
    employmentPosition -> Radno mjesto
    cityOfEmployment -> Mjesto rada - Grad
    requiredProfessionalQualifications -> Potrebna stručna sprema
    employmentContract -> Ugovor o radu
    reasonForDefinite -> Razlog - na određeno
    workingHours -> Radno vrijeme
    hoursForPartTime -> Sati nepuno
    nonWorkingDays -> Neradni dan(i) u tjednu
    dateOfSignUp -> Datum prijave
    dateOfSignOut -> Datum odjave
    basicSalary -> Iznos osnovne plaće
    salaryType -> Bruto / Neto
    foreignNational -> Strani državljanin
    expiryDateOfWorkPermit -> Radna dozvola vrijedi do
    retiree -> Umirovljenik
    youngerThanThirty -> Mlađi od 30 godina
    firstEmployment -> Prvo zaposlenje
    disability -> Invalid
    note -> Napomena
    dateOfSignUpSent -> Datum slanja prijave
    timeOfSignUpSent -> Vrijeme slanja prijave
    dateOfSignOutSent -> Datum slanja odjave
    timeOfSignOutSent -> Vrijeme slanja odjave